1	1	1	1	1	1	1	1	1	1	1	1	1
1	3	t	t	t	0	0	0	0	0	0	0	1
1	0	t	t	t	0	0	0	0	0	0	0	1
1	0	t	t	t	t	0	0	0	0	0	0	1
1	0	0	0	t	t	0	0	0	0	0	0	1
1	0	0	0	0	0	0	0	0	0	0	0	1
1	0	0	0	0	0	0	0	0	0	0	0	1
1	0	0	0	0	0	0	0	0	0	4	0	1
1	0	0	1	1	1	1	1	1	0	0	0	1
1	1	1	1	1	1	1	1	1	1	1	1	1