3	1	1	0	0	0	0	0	0	0	0	0	0
0	1	1	0	0	0	0	0	0	0	0	0	0
0	0	0	1	0	0	0	0	0	0	0	4	0
0	1	0	1	0	0	0	0	t0	t1	0	0	0
0	1	0	1	0	0	0	0	t2	t3	0	0	0
0	1	0	0	0	0	t0	t1	0	0	0	0	0
0	1	0	0	0	0	t2	t3	0	0	0	0	0
0	1	0	0	0	0	0	0	0	0	0	0	0
0	1	0	0	0	0	0	0	0	0	0	0	0
0	1	0	0	0	0	0	0	0	0	0	0	0