0	0	3	0	0	0	0	0	0	0	0	0	0	0	0	0	0	0	0	0
0	0	5	0	0	0	0	0	0	0	0	0	0	0	0	0	0	0	0	0
0	0	8	0	0	0	0	0	0	0	0	0	0	0	0	0	0	0	0	0
0	0	5	1	0	0	0	0	0	0	0	0	0	0	0	0	0	0	0	0
0	0	5	4	0	0	0	0	0	0	0	0	0	0	0	0	0	0	0	0
0	0	10	4	0	0	0	0	0	0	0	0	0	0	0	0	0	0	0	0
5	0	8	4	0	0	0	0	0	0	0	0	0	0	0	0	0	0	0	0
2	0	8	0	2	0	0	0	0	0	0	0	0	0	0	0	0	0	0	0
10	0	0	0	0	0	0	0	0	0	0	0	0	0	0	0	0	0	0	0
10	0	10	5	12	0	0	0	0	0	0	0	0	0	0	0	0	0	0	0